.........
..b...b..
..b...b..
.........
.b.....b.
..b...b..
...bbb...
.........
