.....e...
..b.e.b..
..be..b..
.........
.b..p..b.
..b...b..
...bbb...
.........
