.....e.....
..b.e.bbb..
..be..bbb..
...........
.b.....b...
..b...b.p..
...bbb..bbb
b..........
